{
  "name": "My Maze2",
  "width": 15,
  "height": 15,
  "layout": [
    "###############",
    "#S#.....#...#.#",
    "#.###.#.#.#.#.#",
    "#.....#...#.#.#",
    "###########.#.#",
    "#.........#...#",
    "#.###########.#",
    "#.....#.....#.#",
    "#.###.#.#.###.#",
    "#.#...#.#.....#",
    "#.#.###.#######",
    "#.#.....#.....#",
    "#.#########.#.#",
    "#...........#E#",
    "###############"
  ]
}